XXXXXXXXXXXXXXXXXXX
X--------X--------X
X-XX-XXX-X-XXX-XX-X
X--------O--------X
X-XX-X-XXXXX-X-XX-X
X----X---X---X----X
XXXX-X-XXXXX-X-XXXX
XXXX-X-X---X-X-XXXX
XXXX-X-XXXXX-X-XXXX
X----X---X---X----X
X-XX-X-XXXXX-X-XX-X
X-----------------X
X-XX-XXX-X-XXX-XX-X
X--------X----G---X
XXXXXXXXXXXXXXXXXXX